SO ./texture/metal_box.xpm
WE ./texture/white_floor.xpm
EA ./texture/light_2.xpm
NO ./texture/Floor1.xpm

F 224,200,1
C 233,030,1


11111111111
10000000001
10000000001
100N0000001
10000000001
10000000001
10000000001
10000000001
10000000001
11111111111

