NO ./texture/metal_box.xpm
WE ./texture/white_floor.xpm
EA ./texture/light_2.xpm
SO ./texture/Floor1.xpm

F 224,200,1
C 233,030,1


11111111111111
10000000000001
10000000000001
10000000000001
10000000000001
10100000000001
10000000000001
10000000000001
10000001111001
10000000000001
10000000000001
10000000000001
100000N0000001
11111111111111
