WE ./texture/light.xpm
NO ./texture/metal_box.xpm
EA ./texture/light.xpm
SO ./texture/metal_box.xpm

F 255,0,255
C 0,255,0

1111111111111
100000S000001
1000000000001
10000000000001
1000000000001
10100000000001
10000000000001
10000000000001
10000001111001
10010000000001
10000000000001
10000000000001
10000000000001
1111111111111
