SO ./texture/metal_box.xpm
WE ./texture/white_floor.xpm
EA ./texture/light_2.xpm
NO ./texture/Floor1.xpm

F 224,200,1
C 233,030,1


1111111111 111 1111 11111
1000000101 101 1001 10001
1000000000100010000100001
100N000000000000000000001
1000000000100000000000001
1000000011 11000000000001
10000001     100000000001
10000001     100000000001
11111111     111111111111
