SO ./texture/train.xpm
WE ./texture/train.xpm
EA ./texture/train.xpm
NO ./texture/train.xpm

F 0,0,10
C 0,0,25

111111111111111111111111111111
111111100000000000000001111111
111111000000000000000000111111
111110000000000000000000111111
111110000000000000000000011111
111100000000000000000000011111
111100000000000000000000001111
111000111111111111111111001111
111001111111111111111111001111
111001111111111111111111000111
111001111111111111111111100111
110001111111111111111111100111
110001111111111111111111100111
110011111111111111111111100011
110011111111111111111111100011
110011111111111111111111100011
110000000000000000000000000011
110000000000000000000000000011
110000000000000000000000000011
110000000000000000000000000011
110000000000000000000000000011
1100000000000N0000000000000011
111000000000000000000000000111
111000000000000000000000000111
111000000000000000000000000111
111000011100000000001110000111
111000011100000000001110001111
111100011100000000001110011111
111100000000000000000000011111
111110000000000000000000111111
111111000000000000000001111111
111110000000000000000000111111
111110011111111111111100011111
111100111111111111111110001111
111000000000000000000000000111
110000000000000000000000000011
100001111111111111111111100001
100011111111111111111111110001
100111111111111111111111111001
111111111111111111111111111111
